**  PACMAN **
audacity
bc- > command line calculator
blueman -> then execute: su -c 'systemctl enable bluetooth.service' -> this will enable the Bluetooth icon in notification tray
evince -> PDF reader
filezilla -> FTP client
firefox -> recover the ~/.config/mozilla directory
git -> recover the ~/.gitconfig file
gparted
gummi -> LaTeX editor
iw -> Sprava bezdrotovych adapterov (skenovanie Wi-Fi sieti)
lib32-mesa -> Intel grafika
libreoffice-fresh
libva-intel-driver -> Intel grafika
mesa -> Intel grafika
mousepad -> po instalacii otvorit mousepad, ist do Edit->Preferences->View->Colour scheme->Cobalt (biele pismena na ciernom pozadi)
musescore
ntfs-3g -> NTFS support
openssh -> SSH client and server
opera -> recover ~/.opera directory and sync the settings with opera account
opera-ffmpeg-codecs -> predkompilovane na herecura repozitari - kodeky na podporu videoformatov vratane 60fps videi
p7zip -> command line extraction utility
pavucontrol -> pulseaudio frontend (gui)
#pepper-flash -> podpora adobe flash - nemam ho rad, ale vela televiznych stanic ho pouzivaju na streamovanie
pulseaudio -> audio server
pulseaudio-bluetooth -> umozni prehravat hudbu od inych zariadeni cez bluetooth
python -> python3 support
python-kivy -> Python Kivy cross-platform framework
python-xdg -> dependency for redshift-gtk (tray icon) to launch and run correctly
qemu -> generic virtualizer
redshift -> color temperature changer (spares eyes) -> run on background in tray with "redshift-gtk&" -> right click on the tray icon and enable Autostart
shotwell -> image viewer with nice features (crop, rotate, ...)
tigervnc -> VNC client and server
transmission-gtk -> Bittorrent klient
virtualbox -> zvolit "virtualbox-host-modules-arch". po instalacii vykonat prikaz: gpasswd -a $USER vboxusers
virt-manager -> front-end ku QEMU
tk -> tkinter library for Python
unrar -> needed for dtrx to extract RAR archives
virtualbox-ext-oracle
virtualbox-guest-iso
vlc -> multimedia player
xf86-video-intel -> Intel grafika
xfce4 -> my favourite desktop environment
xorg -> display server
xfce4-pulseaudio-plugin -> Volume control in notification tray
xfce4-xkb-plugin -> Keyboard layout changer in notification tray
wpa_supplicant -> utility to connect to Wi-Fi networks with WPA/WPA2 encryption

**  YAOURT **
dtrx -> command line extraction utility
etcher -> bootable USB creator; replacement for dd
skypeforlinux-bin -> skype-legacy sa neda uz nainstalovat - nezbuildi sa qt4 modul
google-chrome

**  MANUALNE Z INTERNETU **
pycharm -> skopirovat do /opt adresara
vmware -> bud player alebo workstation